35 20
#############
#...........#              ########
#...s...s...################......#
#.................................#
#...........################......#
#.....s.....#              #......#
#......k....#              #......#
#...........#              #......#
#####..######              ###..###
    #..#                     #..#
    #..#                     #..#
    #..#                    ##..##
  ###..####                #......#
  #.......#                #......#
  #.......#                #......#
  #.......#                #......#
  #.......#                #......#
  #.......#                #......#
  #...@...#                #......#
  #########                 ###l##
